20 21
00 00 00 00 00 00 00 00 00 00 00 00 00 00 00 00 00 00 00 00  
00 00 00 00 13 09 09 09 09 09 09 09 09 09 09 09 14 00 00 00 
00 00 00 00 11 08 08 08 08 08 08 08 08 08 08 08 12 00 00 00 
00 00 00 00 11 07 07 07 07 07 07 07 07 07 07 07 12 00 00 00 
00 00 00 00 11 06 06 06 06 06 06 06 06 06 06 06 12 00 00 00 
00 00 00 00 11 01 01 01 01 01 01 01 01 01 01 01 12 00 00 00 
00 00 00 00 11 01 01 01 01 01 21 21 01 01 05 02 12 00 00 00 
00 00 00 00 11 01 01 01 01 01 21 21 01 01 04 01 12 00 00 00 
00 00 00 00 11 02 02 02 02 02 02 02 02 02 03 01 12 00 00 00 
00 00 13 09 17 01 01 01 01 01 21 21 01 01 01 01 18 09 14 00 
00 00 11 01 01 01 01 01 01 01 21 21 01 01 01 01 04 01 12 00 
00 00 11 02 02 02 02 02 02 02 02 02 02 02 02 02 03 01 12 00 
00 13 17 01 01 01 01 01 01 01 21 21 01 01 01 01 01 01 12 00 
00 11 01 01 01 01 01 01 01 01 21 21 01 01 01 01 01 01 12 00 
00 11 01 01 01 01 01 01 01 01 21 21 01 01 01 01 01 01 12 00 
00 11 02 02 02 02 02 02 02 02 02 02 02 02 02 02 02 02 12 00 
00 11 01 01 01 01 01 01 01 01 21 21 01 01 01 01 01 01 12 00 
00 11 01 01 01 01 01 01 01 01 21 21 01 01 01 01 01 01 12 00 
00 11 01 01 01 01 01 01 01 01 21 21 01 01 01 01 01 01 12 00 
00 16 10 10 10 10 10 10 10 10 21 21 10 10 10 10 10 10 15 00 
00 00 00 00 00 00 00 00 00 00 21 21 00 00 00 00 00 00 00 00 

00 00 00 00 00 00 00 00 00 00 00 00 00 00 00 00 00 00 00 00 
00 00 00 00 00 00 00 00 00 00 00 00 00 00 00 00 00 00 00 00 
00 00 00 00 00 00 00 00 00 00 00 00 00 00 00 00 00 00 00 00 
00 00 00 00 00 00 00 00 00 00 00 00 00 00 00 00 00 00 00 00
00 00 00 00 00 00 00 00 00 00 23 23 00 00 00 00 00 00 00 00 
00 00 00 00 00 00 00 00 00 00 22 22 00 00 00 00 00 00 00 00 
00 00 00 00 00 00 00 00 00 00 00 00 00 00 00 00 00 00 00 00 
00 00 00 00 00 00 00 00 00 00 00 00 00 00 00 00 00 00 00 00
00 00 00 00 00 00 00 00 00 00 00 00 00 00 00 00 00 00 00 00 
00 00 00 00 00 00 00 00 00 00 00 00 00 00 00 00 00 00 00 00
00 00 00 00 00 00 00 00 00 00 00 00 00 00 00 00 00 00 00 00 
00 00 00 00 00 00 00 00 00 00 00 00 00 00 00 00 00 00 00 00
00 00 00 00 00 00 00 00 00 00 00 00 00 00 00 00 00 00 00 00 
00 00 00 00 00 00 00 00 00 00 00 00 00 00 00 00 00 00 00 00
00 00 00 00 00 00 00 00 00 00 00 00 00 00 00 00 00 00 00 00 
00 00 00 00 00 00 00 00 00 00 00 00 00 00 00 00 00 00 00 00 
00 00 00 00 00 00 00 00 00 00 00 00 00 00 00 00 00 00 00 00 
00 00 00 00 00 00 00 00 00 00 00 00 00 00 00 00 00 00 00 00 
00 00 00 00 00 00 00 00 00 00 00 00 00 00 00 00 00 00 00 00 
00 00 00 00 00 00 00 00 00 00 00 00 00 00 00 00 00 00 00 00 
00 00 00 00 00 00 00 00 00 00 00 00 00 00 00 00 00 00 00 00 

00 00 00 00 00 00 00 00 00 00 00 00 00 00 00 00 00 00 00 00 
00 00 00 00 00 00 00 00 00 00 00 00 00 00 00 00 00 00 00 00 
00 00 00 00 00 00 00 00 00 00 00 00 00 00 00 00 00 00 00 00 
00 00 00 00 00 00 00 00 00 00 00 00 00 00 00 00 00 00 00 00
00 00 00 00 00 00 00 00 00 00 00 00 00 00 00 00 12 00 00 00 
00 00 00 00 00 00 00 00 00 00 00 00 00 00 00 00 12 00 00 00 
00 00 00 00 00 00 00 00 00 00 00 00 00 00 00 00 12 00 00 00 
00 00 00 00 00 00 00 00 00 00 00 00 00 00 00 00 00 00 00 00
00 00 00 00 00 00 00 00 00 00 00 00 00 00 00 00 00 00 00 00 
00 00 00 00 00 00 00 00 00 00 00 00 00 00 00 00 00 00 00 00
00 00 00 00 00 00 00 00 00 00 00 00 00 00 00 00 00 00 00 00 
00 00 00 00 00 00 00 00 00 00 00 00 00 00 00 00 00 00 00 00
00 00 00 00 00 00 00 00 00 00 00 00 00 00 00 00 00 00 00 00 
00 00 00 00 00 00 00 00 00 00 00 00 00 00 00 00 00 00 00 00
00 00 00 00 00 00 00 00 00 00 00 00 00 00 00 00 00 00 00 00 
00 00 00 00 00 00 00 00 00 00 00 00 00 00 00 00 00 00 00 00 
00 00 00 00 00 00 00 00 00 00 00 00 00 00 00 00 00 00 00 00 
00 00 00 00 00 00 00 00 00 00 00 00 00 00 00 00 00 00 00 00 
00 00 00 00 00 00 00 00 00 00 00 00 00 00 00 00 00 00 00 00 
00 00 00 00 00 00 00 00 00 00 00 00 00 00 00 00 00 00 00 00 
00 00 00 00 00 00 00 00 00 00 00 00 00 00 00 00 00 00 00 00 

00 00 00 00 00 00 00 00 00 00 00 00 00 00 00 00 00 00 00 00  
00 00 00 00 13 09 09 09 09 09 09 09 09 09 09 09 14 00 00 00 
00 00 00 00 11 08 08 08 08 08 08 08 08 08 08 08 12 00 00 00 
00 00 00 00 11 07 07 07 07 07 07 07 07 07 07 07 12 00 00 00 
00 00 00 00 11 06 06 06 06 06 06 06 06 06 06 06 12 00 00 00 
00 00 00 00 11 00 00 00 00 00 00 00 00 00 00 00 12 00 00 00 
00 00 00 00 11 00 00 00 00 00 00 00 00 00 00 00 12 00 00 00 
00 00 00 00 11 00 00 00 00 00 00 00 00 00 00 00 12 00 00 00 
00 00 00 00 11 00 00 00 00 00 00 00 00 00 00 00 12 00 00 00 
00 00 13 09 17 00 00 00 00 00 00 00 00 00 00 00 18 09 14 00 
00 00 11 00 00 00 00 00 00 00 00 00 00 00 00 00 00 00 12 00 
00 00 11 00 00 00 00 00 00 00 00 00 00 00 00 00 00 00 12 00 
00 13 17 00 00 00 00 00 00 00 00 00 00 00 00 00 00 00 12 00 
00 11 00 00 00 00 00 00 00 00 00 00 00 00 00 00 00 00 12 00 
00 11 00 00 00 00 00 00 00 00 00 00 00 00 00 00 00 00 12 00 
00 11 00 00 00 00 00 00 00 00 00 00 00 00 00 00 00 00 12 00 
00 11 00 00 00 00 00 00 00 00 00 00 00 00 00 00 00 00 12 00 
00 11 00 00 00 00 00 00 00 00 00 00 00 00 00 00 00 00 12 00 
00 11 00 00 00 00 00 00 00 00 00 00 00 00 00 00 00 00 12 00 
00 16 10 10 10 10 10 10 10 10 00 00 10 10 10 10 10 10 15 00 
00 00 00 00 00 00 00 00 00 01 00 00 01 00 00 00 00 00 00 00 


